11111111111111111
100010E0010C010C1
10101010101011101
10000010000000001
11101C11101010101
100011100K00C0001
10101110101110101
1K000000000100001
10101010101010101
1000110000C000001
10101110101011101
1K0P00000C0001001
10101010101010101
100K0010K00C01001
10101010101010101
1110C011100K00001
11111111111111111